
        

00000000
11111110
01110110
00010000
01111110
01000110
01110111
00000000
